NO ./png/  blue  wall.png

SO ./png/doorfinal.png

WE ./png/graywall.png

EA ./png/redbrick.png

F 200,200,200

C 100,100,100


1111111111111
10000000LL001
100000S111111
1111111111111