NO ./png/  blue  wall.png

SO ./png/doorfinal.png

WE ./png/graywall.png

EA ./png/redbrick.png

F 200,200,200

C 100,100,100


11111111111111111   11111
10000000000000021   12001
10000000000000001   10001
1000000000000000111110001
1000000000000000000000001
1200000000000000000000001
1000000000000000000000001
1000000000000000000000001
1000000000000000000000001
1000000000000000000000001
1200000000000000000000001
1000000000000000000000001
1000000000000000000000001
1000000000000000000000001
1000000000000000000000001
1000000000000000N00000001
1000000000000000000000001
1200000000000000000000001
1000000000000000000000001
11111000000000000000000011111
    1000000000000000000000021
11111000000000000000000011111
1200000000000000000000001
1200000000000000020000001
1111111111111111111111111